21 21 12 12 12 12 12 11 12 12 12 12 12 21 21
21 21 12 15 0 0 0 12 0 0 0 0 12 21 21
12 12 12 0 11 0 0 12 0 0 11 0 12 12 12
12 0 0 11 13 11 0 12 0 11 13 11 0 0 12
12 0 0 0 11 0 0 12 0 0 11 0 0 0 12
12 12 0 0 0 0 0 21 0 0 0 0 0 12 12
21 21 12 12 12 12 12 21 12 12 12 12 12 21 21
12 12 0 0 0 0 0 12 0 0 0 0 0 12 12
12 0 0 0 11 0 0 12 0 0 11 0 0 0 12
12 0 0 11 13 11 0 12 0 11 13 11 0 0 12
12 12 12 0 11 0 0 12 0 0 11 0 12 12 12
21 21 12 0 0 0 0 12 0 0 0 16 12 21 21
21 21 12 12 12 12 12 11 12 12 12 12 12 21 21